...................###...,
...f######.........#b#...,
.....##a.................,
....######...............,
......................##.,
....................####c,
...###......m##....e##...,
...#g.......##n....###...,
...###..............###..,
....................###..,
....................#d#..,
....###h###..............,
....................j####,
......####l####k....#####
